NO ./textures/bricks/no.xpm
SO ./textures/bricks/so.xpm
WE ./textures/bricks/we.xpm
EA ./textures/bricks/ea.xpm

F 61,60,58
C 156,165,204

        11111111
    1111100000011
    1001000000001
    1100000000001
     1000000000011
     1100000000001
      101001000001
 111  101001000011
 1011110000001001
110000010111100111
1000000010000010011
11000000011011000011
 11111000000000010011
     1100000000110001
      100000001110001
      1000N0001110011
      10000000111111
     11000000001
    1100001000011
   110001111100011
 11100001   10000111
110000001   100000011
111111111   111111111