NO ./textures/no.xpm
SO ./textures/so.xpm
WE ./textures/we.xpm
EA ./textures/ea.xpm

F 55,55,42
C 79,88,100

111111111111111111111111111111111
100000000000000000000000111111111
100100000011000000S00000111111111
101100000111000000000000111111111
100100000000000000000000111111111
111111111011000001110000000000000
100000000011000001110111100011111
111101111111110111000000100011111
111101111111110111010100100011111
110000001101010111000000100011111
100000000000000011000000100011111
100000000000000011010100100011111
100000011101010111110111100011111
101101111111010111011110100011111
111111111111111111111111111111111
