NO ./textures/no.xpm
SO ./textures/so.xpm
WE ./textures/we.xpm
EA ./textures/ea.xpm

F 55,55,42
C 100,100,79

        111111        111111    
       1100001        1000011   
       1000011        1000001111
      1101111   1111111101100001
      10000011111000000001100001
      10000000000000000101100001
      10000011111000000101100001
      1000001   1000000101111111
      111011111110000000001     
        1000000010000001101     
     1111111111011101111101     
     1000000001010000000001     
111111000000000010110111111     
100001000000001110100111111111  
100001000000001110111110000001  
100000000000000000000000000001  
1000010000000011111101100N0001  
111111000000001100000011111111  
     111111111110000001         
               10000001         
               10000001         
               10000001         
               11111111         
