NO ./textures/no.xpm
SO ./textures/so.txt
WE ./textures/we.txt
EA ./textures/ea.txt

F 220,100,0
C 225,30,0

111111111111111111111111111111111111111111111111111111111111111111111111111
1N0000000000000000000000000000000000000000000000000000000000000000000000001
100100000011000000000000000000000000000000000000000000000000000000000000001
101100000111000000000000000000000000000000000000000000000000000000000000001
100100000000000000000000000000000000000000000000000000000000000000111111111
111111111011000001110000000000000000000000000000000000000000000000000000001
100000000011000001110111100000000000000000000000000000000000000000000011111
100000000011000001110111100000000100000000000000000000000000000000000011111
100000000011000001110111100000000100000000000000000000000000000000000001111
100000000011000001110111100000000100000000000000000000000000000000000000111
100000000011000001110111100000000111111000000000000000000000000000000000001
100000000011000001110111100000000000000000000000000000000000000000000000111
100000000011000001110111100000000000000000000000000000000000000000000001111
100000000011000001110111100000000000000000000000000000000000000000000000001
100000000011000001110111100000000010000000000000000000100000000000000000001
100000000011000001110111100000000001000000000000000001000000000000000000001
100000000011000001110111100000000000100000000000000010000000000000000000001
100000000011000001110111100000000000010000000000000100000000000000000000001
100000000011000001110111100000000000001000000000001000000000000000000000001
100000000011000001110111100000000000000100000000010000000000000000000000001
100000000011000001110111100000000000000010000000100000000000001000000000001
100000000011000001110111100000000000000001000001000000000000001000000000001
100000000011000001110111100000000000000000100010000000000000001000000000001
100000000011000001110111100000000000000000010100000000000000001000000000001
100000000011000001110111100000000000000000000000000000000000001000000000001
100000000011000001110111100000000000000000111110000000000000001000000000001
100000000011000001110111100000000000000000001000000000000000001000000000001
100000000011000001110111100000000000000000001000000000000000001000000000001
100000000011000001110111100000000000000000001000000000000000001000000000001
100000000011000001110111100000000000000000001000000000000000001000000000001
100000000011000001110111100000000000000000001000000011111111111000000000001
100000000011000001110111100000000000000000001000000000000000000000000000001
100000000011000001110111100000000000000000000000000000000000000000000000001
100000000011000001110111100000000000000000001000000000000000000000000000001
100000000011000001110111100000000000000000001000000000000000000000000000001
100000000011000001110111100000000000000000001000000000000000000000000000001
100000000011000001110111100000000000000000000000000000000000000000000000001
100000000011000001110111100000000000000000000000000000000000000000000000001
100000000011000001110111100000000000000000000000000000000000000000000000001
100000000011000001110111100000000000000000000000000000000000000000000000001
100000000011000001110111100000000000000000000000000000000000000000000000001
100000000011000001110111100000000000000000000000000000000000000000000000001
100000000011000001110111100000000000000000000000000000000000000000000000001
111101111111110111000000100000000000000000000000000000000000000000000000001
111101111111110111010100100000000000000000000000000000000000000000000000001
110000001101010111000000100000000000000000000000000000000000000000000000001
100000000000000011000000100000000000000000000000000000000000000000000000001
100000000000000011010100100000000000000000000000000000000000000000000000001
110000011101010111110111100000000000000000000000000000000000000000000000111
11110111 1110101 1011110100000000000000000000000000000000000000000000000001
11111111 1111111 1111111111111111111111111111111111111111111111111111111111