NO ./textures/lab/no.xpm
SO ./textures/lab/so.xpm
WE ./textures/lab/we.xpm
EA ./textures/lab/ea.xpm

F 55,55,42
C 100,100,79

                111                          
                121                          
               11B11                         
              1100011                        
        111111100000111111111111111111111    
  1111111000000000000000000000011000000011   
  100000D0000000XK0000000X00000D0000000001   
 11D11111000000000000000000000010X11011001111
1100011 1111111000001111111111111111011001001
1X00001       1100X11              100000D001
1001001        11111    111111111111011001X01
1001X01                 1000000D0011011X011J1
1001001                 1011111100X0000001111
1001001                 101    11000000011   
1001001                 101     111111111    
1001001     111         101                  
100X001    11L11        101         111111   
1100011   1100011    1111D1111     11000011  
 11D11  11100001111 11000000011   1100000011 
  1011111000X001001110000X000011111000000001 
  100000D00001X0X0010000000000D000D00000W001 
  111111100X010000111000000X00111110C0000001 
        11100100111 11000000011   1100000011 
          1101011    111111111     11000011  
           11111                    111111   
            111                              